11111
10P01
11001
1C0E1
11111
11111
11111
